1111111
1000001
1000001
10001X1
1111001
11P0CE1
1111111
