1111111
1000001
1000001
100011
1111001
11P0CE1
1111111
