11111111111111
100C00C0000001
100E0P10110C01
10000C00001001
1001001E000C01
11111111111111
