11111111111111111111
10000101C00000000001
10001C0010000E000001
10010000110010111C11
10100000000101011111
10010P00001110111011
1000100011000E011011
10000100000000C11011
10000011111111110001
11111111111111111111
