11111111111
1E11CCCCC11
101CC111CC1
101C1CCC1C1
1P1C1CEC1C1
1C1C1CCC1C1
1C1CCC11CC1
1CC111CCC11
11CCCCC1101
11111111111
