1111111111111
1000000000001
100C010011C01
1000100100101
100100E001001
10111110100P1
1000100100001
1000100111101
10000CC000001
1000000000001
1111111111111
