11111111111
10000000001
11C10P01C11
10100E00101
10000100001
10001C10001
10000000001
11111111111
